+--+--+--+--+--+--+--+--+--+--+
|  |     |                    |
+  +  +  +--+  +--+--+  +--+  +
|     |     |  |     |     |  |
+--+--+--+  +  +  +  +--+  +  +
|  |        |  |  |     |  |  |
+  +  +--+--+  +--+  +  +  +--+
|  |     |  |        |  |     |
+  +--+  +  +--+--+  +--+--+  +
|        |    x|     |        |
+  +--+--+  +--+  +--+  +--+  +
|        |           |     |  |
+--+--+  +  +--+--+--+--+  +  +
|     |  |        |        |  |
+  +  +  +--+--+  +  +--+--+  +
|  |     |        |     |     |
+  +--+--+  +--+--+--+  +  +--+
|        |  |        |  |     |
+--+--+  +--+  +--+  +  +--+  +
|              |        |     |
+--+--+--+--+--+--+--+--+--+--+